###############################
#A  #   #             # #     #
# # ### # # ######### # # ### #
# #   # # # #       #   #   # #
# ### # # # ##### # ### ### # #
#   #   # #     # # #   #   # #
### # ### ##### # # # ### ### #
#   # #   #   # # #   # # # # #
# ### # ##### # ### ### # # # #
#   # # #     #   #     # #   #
### ### # ####### ##### ### ###
#   #   # #       #   #   #   #
# ### ### # ####### ##### ### #
# #   #   #   #           #   #
# # ### # ### ########### # ###
# #     #   # #   #     # #   #
# ##### ##### # # # ### ##### #
#     # #     # # # # # #     #
# # ### # ##### # # # # # #####
# #     #       #     #      B#
###############################
